11111111111111111111111111111111111111111111111111111111111111111111111111111111
10000000000000000000000000000000000000000000000000000000000000000000000000000001
10000000000000000000000000111111111111111111111111111000000000000000000000000001
10000000000000000000000011100000000000100000000000001110000000000000000000000001
10000000000000000000001110000111110000100001111111000011100000000000000000000001
10000000000000000000111000011100000000100000000001110000111000000000000000000001
10000000000000000011100001110000111111111111111000011100001110000000000000000001
10000000000000001110000111000011100000000000001110000111000011100000000000000001
10000000000000001000011100001110000111111111000011100001110000100000000000000001
10000000000000001000010000111000011100000001110000111000010000100000000000000001
10000000000000001000010000100001110000222000011100001000010000100000000000000001
10000000000000001000010000100001000000000000000100001000010000100000000000000001
10000000000000001000010000100001777777000777777100001000010000100000000000000001
10000000000000001000010000100001000000000000000100001000010000100000000000000001
10000000000000001000010000100001110000000000011100001000010000100000000000000001
10000000000000001000010000111000011100000001110000111000010000100000000000000001
10000000000000001000011100001110000111110001000011100001110000100000000000000001
10000000000000001110000111000011100000010001000000000111000011100000000000000001
10000000000000000011100001110000111000010001000000111100001110000000000000000001
10000000000000000000111000011100000000010001000011100000111000000000000000000001
10000000000000000000011100000111111111110001111110000011100000000000000000000001
10000000000000000000000111000000000000010000000000001110000000000000000000000001
10000000000000000000000001111111111000011111111111111000000000000000000000000001
10000000000000000000000000000000001000010000000000000000000000000000000000000001
11111111111111111111111111111111111111111111111111111111111111111111111111111111
