11111111111111111111111111111111111111111111111111111111111111111111111111111111
11111111111111111110222220111111111111111111000000000001111111111111111111111111
11111111111111111110000000111111000000000000000000000001111110000011110000011111
11111111111111111110000000111111000000000000000000000000000000000000000000011111
11111111111111111110000111111111000000111111000000000000000000000011110000011111
11111111111111111110000000111111000000000111000000000000000000000011111111111111
11111111111111111111111000111111000000000111111111111111111110000011111111111111
11111100000000000000000000111111111111111111111111111111111110000011111111111111
11111100000000000000000000000000000000000000000000000000000000000000011111111111
11111100000000000000000000000000000000000000000000000000000000000000011111111111
11111111111111000111111000000000000000000000000000000000000000000000011111111111
11111111111111000111111111111111111100000000000000000000000000000000011111111111
11111111111111000111111111111111111100000011111000110001100011111100011111111111
11000000000011000000000000001111111100000011111000110001100011111100011111111111
11000000000011000000000000001111111100000011111111111111111111111100011111111111
11001111000011000000000000001111111100000000001111111111111111111100011111111111
11000011111111000000000000001111111100000000001111111111111111111100011111111111
11000011111111000000000000001111111111111000001111111111111000000000000000011111
11000000000000000000000000000000000000000000001111111111111000000000000000011111
11000000000000000000000000000000000000000000001111111111111000000000000000011111
11000000000000000000000000000000000000000000001111111111111000000000000000011111
11000000000001111111111111111111111111111111111111111111111000000000000000011111
11000000000001111111111111111111111111111111111111111111111000000000000000011111
11111111111111111111111111111111111111111111111111111111111111111111111111111111
11111111111111111111111111111111111111111111111111111111111111111111111111111111
