11111111111111111111111111111111111111111111111111111111111111111111111111111111
10000000000000000000000000000000000000000000000000000000000000000000000000000001
10000000000000000000000000011111111111111111110000000000000000000000000000000001
10000000000000000000000001100000000010000000001100000000000000000000000000000001
10000000000000000000000110000111100010001111000011000000000000000000000000000001
10000000000000000000011000011000000010000000110000110000000000000000000000000001
10000000000000000001100001100001111111111100001100001100000000000000000000000001
10000000000000000110000110000110000000000011000011000011000000000000000000000001
10000000000000001000011000011000011111110000110000110000100000000000000000000001
10000000000000001000100001100001100000001100001100001000100000000000000000000001
10000000000000001000100010000110000222000011000010001000100000000000000000000001
10000000000000001000100010001000000000000000100010001000100000000000000000000001
10000000000000001000100010001000000000000000100010001000100000000000000000000001
10000000000000001000100010001000000000000000100010001000100000000000000000000001
10000000000000001000100010000110000000000011000010001000100000000000000000000001
10000000000000001000100001100001100000001100001100001000100000000000000000000001
10000000000000001000011000011000011110001000110000110000100000000000000000000001
10000000000000000110000110000110000010001000000011000011000000000000000000000001
10000000000000000001100001100001100010001000001100001100000000000000000000000001
10000000000000000000011000011000000010001000110000110000000000000000000000000001
10000000000000000000000110000111111110001111000011000000000000000000000000000001
10000000000000000000000001100000000010000000001100000000000000000000000000000001
10000000000000000000000000011111100011111111110000000000000000000000000000000001
10000000000000000000000000000000000000000000000000000000000000000000000000000001
11111111111111111111111111111111111111111111111111111111111111111111111111111111
