11111111111111111111111111111111111111111111111111111111111111111111111111111111
11110000000000000000000000000000000000000000000000000011111111111111111111111111
11110000000000000001111111100000111110000000000000000001111111111111111111111111
11110000000000000011111111000001111111100000000011100000000000000000011111111111
11110000000000001111111111000011111111100011110001111100000000000000000000011111
11000000000000000000000000000000000000001000000000011111111111100000011100011111
11000011111110000000000000000000000000000000000000011111111111100011111100011111
10000000000000001111111111000100000000001000000000000000000000000000011100011111
10000000000000001111111000000100000000001000000000000000000000000000000000001111
10001111111000111111111000000111111111111111111111111111000111100000011100011111
10001111110001111111000000000000000000000000000000011111100011100000011000111111
10001111100000000011000000000000000000000000000000011111100011100000010001111111
10001111000111000000000111000111111111111111111111111111000111100000000011111111
10000000000001111000000001000111111111111111111111111110001110000110001111111111
10000000000000111111110001100000011111000000000000000111000000111100000011111111
11111111100000011111100011110000000111000000000000000000000000000000000000011111
11111111000110001111000000100010001000000000000000000111111111111000000100011111
10000000000011000000000000011100000011000000000000111111111111111000000100011111
10000000000111100000000000000000000011111000000000000000000000111000000100011111
10000000001111111100000000000000000000000000000000011000111000111000111100011111
10000400000000000000000011111100000000000000000000011000000000000000111155111111
10000000000000000000111111111111000110000000000011111000000111111000005000000111
10000000001111110001100000000000000000100000000011111000000000000000001000000111
11111111111111111000000000000000000111111111111111111000000000000000111222220111
11111111111111111111111111111111111111111111111111111111111111111111111111111111
