11111111111111111111111111111111111111111111111111111111111111111111111111111111
10000001111111111100022222000111111111111100000000000000000000000000000000000001
10000011111111111110000000001111111111111110000000000000000000000000000000000001
10000011111111111111155555555511111111111111110000000000000000000000000000000001
10000001111111111111000000000000111111111111000000000000111111111111110000000001
10000000001111111100000000000000000000000000000000000000111111111111100000000001
10000000000000000000000000000000000000000000000000000011111111111111100000000001
10000000000000000000000000000000000000000000000000000111111111111111100000000001
10000000000000000000000111111111111000000000000000011111111111111111000000000001
10000000000000000000000111111111110000000000000000000000000000000000000000000001
10000000000000000000001111111110000000000111111111111000000000000000000000000001
10000000000000000000000111111111000000000111111110000003333333000000111111000001
10000000000000000000000001111111000000001111111110000003333333333311111111100001
10001111111110000000000000000000000000000000000000000000333333333311111111110001
10011111111100000000000000000000000000000000000000000003333333000111111111100001
10000011111000000011111111111100000000000000000000000000000000000111111100000001
10000000000000000000111111111111100000000000000000000000000000000000000000000001
10000000000000000000001111111111110000000000001111111111111000000000000000000001
10000000000000000000000000111111110000000000000000111111111110000000000000000001
10000000000000000000000000000000000000000000000000111111111100000000000000000001
11110000000000000000000000000000000000000000000001111111111000000000004000000001
11111100000000000000000000111111111000000000000000000000000000000000000000000001
11111110000000000000000000111111111100000000000000000000000000000000000000000001
11111111100000000000000000111111111100000000000000000000000000000000000000000001
11111111111111111111111111111111111111111111111111111111111111111111111111111111
