11111111111111111111111111111111111111111111111111111111111111111111111111111111
10000000000000000010000000000000000000000000000010000000100000000100000000000001
10001100010001111110000000000011111111111111100010001000100010000100011111110001
10001000010000000000001000100000000000000000100010001000100010000100000000010001
10001000110001100010001111100011111111111111100010001000100010001111111100010001
10001000010001000010000000000000000000000000100000001000000010001000000000010401
10001100010001000010000000000000000111111111111111111111111111000000011111110001
10001000010000000010001111111110000000100000010000000100000001000000000100011111
10001000111111000010001000000010000100000100000001000000010001000000000000012221
10001000100001111110001111100010000111111111111111111111111001100011111111110001
10001000000000000000000000100010000000000000010000000000001000000000000000010001
10000000100010000000000000100010000000000000010000000000001111111111111000110001
11110000111111111111111111100011111111000111110000100010001000100011000000010001
10000000000000000000000000000000000000000000010000100010001000000001000111110001
10001111111111111111000111111111111111111100011000100010001000010001000000010001
10001000000000000001000100000000000000000000000000100010001000010001111111111511
10001000111111110001000100011111111111111111111000100010000000010001000000010001
10000000100000000001000100000000000000010000000000000011111000011111111100010001
11110000100011111111000111111111111100010001111111100010000000000000000000000001
10000000100010000000000000000000000100010000000000100011110001111000000111100001
10001000100010001111111111111111000100011111111000100010000001000000111100000001
10001000100000001000000000000000000100010000000000100011110001111000000111100001
10001000111111111001000111111111111100010001111111100010000001000000000100000001
10001000000000000001000000000000000000000000000000000010001111000000111100001111
11111111111111111111111111111111111111111111111111111111111111111111111111111111